{
    "positions":[
        "01!01/24",
        "01!02/24",
        "01!03/24",
        "01!04/24",
        "01!05/24",
        "01!06/24",
        "01!07/24",
        "01!08/24",
        "01!09/24",
        "01!10/24",
        "01!11/24",
        "01!12/24",
        "02!02/24",
        "02!03/24",
        "02!04/24",
        "02!05/24",
        "02!06/24",
        "02!07/24",
        "02!08/24",
        "02!09/24",
        "02!10/24",
        "02!11/24",
        "02!12/24",
        "02!13/24"
    ]
}